xxxxxxxxxxxxxxxxxxxxxxxxxxxx
x_________________________px
x__________________________x
x___2______________1_______x
x___x______________________x
x___x______________x_______x
xxxxx______________________x
x__________________________x
x________xxx_______2_______x
x________x_________________x
x________x_________________x
x__1_____x______x__________x
x__________________________x
x__________________________x
x__________________________x
x_______________2__________x
xxxxxxxxxxxxxxxxexxxxxxxxxxx
