xxxxxxxxexxx
xp_________x
x__________x
x__________x
x__________x
x___2______x
x__________x
x__________x
x__________x
x__________x
x__________x
xxxxxxxxxxxx