xxxxxxxxxxxxxxxxx
x________x______x
x____2___x______x
x________x1_____x
x_______________x
x_______________e
x_______________x
x_______________x
x_________2_____x
x_______________x
xp______________x
xxxxxxxxxxxxxxxxx
